%%%%%%%%%%%%%%%%
% P           .%
%.%% %%.%% %% %%
%     oo oo o o%
% %%%%%%%%%%%%o%
% %%%%%%%%%%%%o%
% %%%%%%%%%%%%o%
% %%%%%%%%%%%%o%
%.ooooooooooooo%
%%%%%%%%%%%%%%%%